XXXXXXXXXXXXXXXXXXXXXXXXXXXXXXXXXXXXXXXXXXX
XXXXXXXXXXXXXXXXXSR1FXXXXXXXXXXXXXXXXXXXXXX
XXXXXXXXXXXXXXXXX234FXXXXXXXXXXXXXXXXXXXXXX
XXXXXXXXCCCCCCCCCCFFFXXXSL1XXXXXXXXXXXSR1XX
XXXXXXXXCCCCCCCCCCFFFXXX234XXXXXXXXXXX234XX
XXXXXXXXXXXXXXXXXXXXXXXXXFCCCCCCCCCCCCSR1FF
XXXXXXXXXXXXXXXXXXXXXXXXXXXCCCCCCCCCCC234FF
XXXCSL1XXXXXXXXXXXXXXXXXXXXXCCCCCCCCCCFFFFF
XXXC234XXXXXXXXXXXXXXXXXXXXXXXXXXXXXXXXXXXX
XXXCCCCCCCCCCCCCCCCCXXXXXXXXXXXXXXXXXXXXXXX
XXXXXXXXXXXXXXXXXXXXCCCCCCXXXXXXXXXXXSR1XXX
XXXXXXXXXXXXXXXXXXXXXXXXXXCCXXXXXXXXX234XXX
XXXXXXXXXXXXXXXXXXXXXXXXXXXXCCCCCCCCCCCXXXX
XXXXXXXXXXXXXXXXXXXXXXXXXXXXSL1CCCCCCXXXXXX
XXXXXXXXXXXXXXXXXBXXXXXXXXXX234XXXXXXXXXXXX
XXXXXXXXXXXBXCCCCCCCCCCCCCCCCCCXXXXXXXXXXXX
XXXXXXXCSL1XXXXXXXXXXXXXXCCCCCCCCCCCXXXXXXX
XXXXXXXC234CCXXXXXXXXXXXXXXXXXXXXXXXCCXXXXX
XXXXXXXCCCCXXXXXXXXXXXXXXXXXXXXXXXXXXXSR1XX
XXXXXXXXCCCCCXXXXXXXXXXXXXXXXXXXXXXXXX234XX
XXXXXXXXXCCCCCXXBXXXXXXXXBXXXXXXXXCCCCCFFXX
XXXXXXXXXXXXXXCCCCCCCCCCCCCCCCCCCCFFFFFFFXX
XXXXXXXXXXXXXXXXXXXXXXXXXXXXXXXXXXXXXXXXXXX
FFFFFFFFFFFFFFFFFFFFFFFFFFFFFFFFFFFFFFFFFFF
XXXXXXXXXXXXXXXXXXXXXXXXXXXXXXXXXXXXXXXXXXX
XXXXXXXXXXXXXXXXXXXXXXXXXXXXXXXXXXXXXXXXXXX
XXXXXXXXXXXXXXXXXXXXXXXXXXXXXXXXXXXXXXXXXXX
XXXXXXXXXXXXXXXXXXXXXXXXXXXXXXXXXXXXXXXXXXX
