XXXXXXXXXXXXXXXXXXXXXXXXXXXXXXXXXXXXXXXXXXX
XXXXXXXXXXXXXXXXXXXXXXXXXXXXXXXXXXXXXXXXXXX
XXXXXXSL1XXXXXXXXXXXXXXXSR1XXXXXXXXXXXXXXXX
XXXXXX234XXXXXXBXXXXXXXX234XXXXXXXXXXXXXXXX
XXXXXXCCCCCCCCCCCCCCCCCCCCCXXXXXXXXXXXXXXXX
XXXXXXFXXXXXXXXXXXXXXXXXXXFXXXXXXXXXXXXXXXX
XXXXXXFXXXXXXXXXXXXXXXXXXXFXXXXXXXXXXXXXXXX
XXXXXXFXXXXXXXXXXXXXXXXXXXFXXXXXXXXXXXXXXXX
XXXXXXFXXXXXXXXXXBXXXXXXXXFXXXXXXXXXXXXXXXX
XXXXXXFXXXXFFFFFFFFFFFFFFFFXXXXXXXXXXXXXXXX
XXXXXXFXXXXXXXXXXXXXXXXXXXXXXXXXXXXXXXXXXXX
XXXXXXFXXXXXXXXXXXXXXXXXXXXXXXXXXXXXXXXXXXX
XXXXXXFXXXXXXXXXXXXXXXXXXXXXXXXXXXXXXXXXXXX
XXXXXXFXXXXXXXXXXXXXXXXXXXXXXXXXXXXXXXXXXXX
XXXXXXFXXXXXXXXXXXXXXXXXXXXXXXXXXXXXXXXXXXX
XXXXXXFXXXXXXXXXXXXXXXXXXXXXXXXXXXXXXXXXXXX
XXXXXXFSL1XXXXXXXXXXXXXXXXXXXXXXXXXXXXXXXXX
XXXXXXF234XXXXXXXBXXXXXXXXXXXXXXXXXXXXXXXXX
XXXXXXFFFFFFFFFFFFFFFFFFFFFXXXXXXXXXXXXXXXX
XXXXXXXXXXXXXXXXXXXXXXXXXXXXXXXXXXXXXXXXXXX
XXXXXXXXXXXXXXXXXXXXXXXXXXXXXXXXXXXXXXXXXXX
SL1XXXXXXXXXXXXXXXXXXXXXXXXXXXXXXXXXXXXXSR1
234XXXXXXXXXXXXXXBXXXXXXXXXXXXXXXXXXXXXX234
FFFFFFFFFFFFFFFFFFFFFFFFFFFFFFFFFFFFFFFFFFF
XXFFFFFFFXXFFXFFFFFFFFFFXXXXXXXXXXXXXXXXXXX
XXXXXXXXXXXXXXXFFXXFXXXXXXXXXXXXXXXXXXXXXXX
XXXXXXXXXXXXXXXXXXXXXXXXXXXXXXXXXXXXXXXXXXX
XXXXXXXXXXXXXXXXXXXXXXXXXXXXXXXXXXXXXXXXXXX
