XXXXXXXXXXXXXXXXXXXXXXXXXXXXXXXXXXXXXXXXXXX
XXXXXXXXXXXXXXXXXXXXXXXXXXXXXXXXXXXXXXXXXXX
XXXXXXXXXXXXXXXXXXXXXXXXXXXXXXXXXXXXXXXXXXX
XXXXXXXXFSL1XXXXXXXXXXXXXXXXXXXXXXXXXXXXXXX
XXXXXXXXF234XXXXXXXXXXXXBXXXXXXXXXXXXXXXXXX
XXXXXXXXFFFFFFFFFFFFFFFFFFFFFFFFFFFFFFXXXXX
XXXXXXXXFFFFFFFXXXXXXFFFFFFXXXXXXFFFFFXXXXX
XXXXXXXXXXXXXXXXXXXXXXXXXXXXXXXXXXXXXXXXXXX
XXXXXXXXXXXXXXXXXXXXXXXXXXXXXXXXXXXXXXXXXXX
XXXXXXXXXXXXXXXXXXXXXXXXXXXXXXXXXXXXXXXXSR1
XXXXXXXXXXXXXXXXXXXXBXXXXXXXXXXXXXXXXXXX234
XXXXXXFFFFFFFFFFFFFFFFFFFFFFFFFFFFFFFFFFFFF
XXXXXXFFFFFFXXXXXFFFFFFXXXXXFFFFFFXXXXFFFFF
XXXXXXXXXXXXXXXXXXXXXXXXXXXXXXXXXXXXXXXXXXX
XXXXXXXXXXXXXXXXXXXXXXXXXXXXXXXXXXXXXXXXXXX
SL1XXXXXXXXXXXXXXXXXXXXXXXXXXXXXXXXXXXXXSR1
234BXXXXXXXXXXXXXXXXXXXXXBXXXXXXXXXXXXXX234
FFFFFFXXXXXXFFFFFFFFFFFFFFFFFFFFFFFFFFFFFFF
FFFFFFXXXXXXFFFFFXXXXXXFFFFFXXXXXXFFFFFFFFF
FXXXXXXXXXXXXXXXXXXXXXXXXXXXXXXXXXXXXXXXXXX
FXXXXXXXXXXXXXXXXXXXXXXXXXXXXXXXXXXXXXXXXXX
FXXXXXXXXXXXXXXXXXXXXXXXXXXXXXXXXXXXXXXXSR1
FXXXXXXXXXXXXXXXXXXXXXXXXXXXXXXXXXXXXXXX234
FFFFFFFFFFFFFFFFFFFFFFFFFFFFFFFFFFFFFFFFFFF
XXXXXXXXXXXXXXXXXXXXXXXXXXXXXXXXXXXXXXXXXXX
XXXXXXXXXXXXXXXXXXXXXXXXXXXXXXXXXXXXXXXXXXX
XXXXXXXXXXXXXXXXXXXXXXXXXXXXXXXXXXXXXXXXXXX
XXXXXXXXXXXXXXXXXXXXXXXXXXXXXXXXXXXXXXXXXXX
