
XXXXXXXXXXXXXXXXXXXXXXXXXXXXXXXXXXXXXXXXXXX
XXXXXXXXXXXXXXXXXXXXXXXXXXXXXXXXXXXXXXXXXXX
XXXXXXXXXXXXXXXXXXXXXXXXXXXXXXXXXXXXXXXXXXX
XXXFFSL1XXXXXXXXXXXXXXXXXXXXXXXXXSR1FFXXXXX
XXXFF234XXXBXXXXXXXXXXXXXXXXXXXXX234FFXXXXX
XXXFFFFFFFFFFFFCCCCCCCCFFFFFFFFFFFFFFFXXXXX
XXXXXXXXXXXXXXXXXXXXXXXXXXXXXXXXXXXXXXXXXXX
XXXXXXXXXXXXXXXXXXXXXXXXXXXXXXXXXXXXXXXXXXX
XXXFFSL1XXXXXXXXXXXXXXXXXXXXXXXXXSR1FFXXXXX
XXXFF234XXXXXXXXXXXXXXXXXXXXXBXXX234FFXXXXX
XXXFFFFFFFFFFFCCCFFFFFFFFCCCFFFFFFFFFFXXXXX
XXXXXXXXXXXXXXXXXXXXXXXXXXXXXXXXXXXXXXXXXXX
XXXXXXXXXXXXXXXXXXXXXXXXXXXXXXXXXXXXXXXXXXX
XXXFFSL1XXXXXXXXXXXXXXXXXXXXXXXXXSR1FFXXXXX
XXXFF234XXXXXXXXXXXXBXXXXXXXXXXXX234FFXXXXX
XXXFFFFFFCCCCCFFFFFCCCFFFFFFFCCCFFFFFFXXXXX
XXXXXXXXXXXXXXXXXXXXXXXXXXXXXXXXXXXXXXXXXXX
XXXXXXXXXXXXXXXXXXXXXXXXXXXXXXXXXXXXXXXXXXX
XXXFFXXXXXXXXXFXXXXXXXXXFXXXXXXXXXXXFFXXXXX
XXXFFXXXXXXXXXFXXXXXXXXXFXXXXXXXXXXXFFXXXXX
XXXFFFFFFFFFFFFFFFFFFFFFFFFFFFFFFFFFFFXXXXX
XXXXXXXXXXXXXXXXXXXXXXXXXXXXXXXXXXXXXXXXXXX
XXXXXXXXXXXXXXXXXXXXXXXXXXXXXXXXXXXXXXXXXXX
XXXXXXXXXXXXXXXXXXXXXXXXXXXXXXXXXXXXXXXXXXX
XXXXXXXXXXXXXXXXXXXXXXXXXXXXXXXXXXXXXXXXXXX
XXXXXXXXXXXXXXXXXXXXXXXXXXXXXXXXXXXXXXXXXXX
XXXXXXXXXXXXXXXXXXXXXXXXXXXXXXXXXXXXXXXXXXX