XXXXXXXXXXXXXXXXXXXXXXXXXXXXXXXXXXXXXXXXXXX
XXXXXXXXXXXXXXXXXXXXXXXXXXXXXXXXXXXXXXXXXXX
XXXXXXXXXXXXXXXXXXXXXXXXXXXXXXXXXXXXXXXXXXX
XXXXXXXXXXXXXXXXXXXXXXXXXXXXXXXXXXXXXXXXXXX
XXXXXXXXXXXXXXXXXXXXXXXXXXXXXXXXXXXXXXXXXXX
FSL1XXXSR1XXXXXXXXXXXXXXXSL1XXXXXXXXXXXSR1F
F234XXX234XXXXXXXXXXXXXXX234XXXXXXXXXXX234F
FFFFCCFFFFXXXXXXXXXXXXXXXFFFFFCCFFFCCFFFFFF
FXXXXXXXXFXXXXXXXXXXXXXXXFXXXXXXXXXXXXXXXXF
FXXXXXXXXFXXXXXXXXXXXXXXXFXXXXXXXXXXXXXXXXF
FSL1XXSR1FXXXXXXXXXXXXXXXFSL1XXXXXXXXXXSR1F
F234XB234FXXXXXXXXXXXXXXXF234XBXXXXXXXX234F
FFFFFCCFFFXXXXXXXXXXXXXXXFFFFFCCFFFCCFFFFFF
FXXXXXXXXFXXXXXXXXXXXXXXXFXXXXXXXXXXXXXXXXF
FXXXXXXXXFXXXXXXXXXXXXXXXFXXXXXXXXXXXXXXXXF
FSL1XXSR1FXXXXXXXXXXXXXXXFSL1XXXXXXXXXXSR1F
F234BX234FXXXXXXXXXXXXXXXF234XXXXBXXXXX234F
FFFCCCFFFFXXXXXXXXXXXXXXXFFFFFCCFFFCCFFFFFF
FXXXXXXXXXXXXXXXXXXXXXXXXXXXXXXXXXXXXXXXXXF
FXXXXXXXXXXXXXXXXXXXXXXXXXXXXXXXXXXXXXXXXXF
FSL1XXXXXXXXXXXXXXXXXXXXXXXXXXXXXXXXXXXSR1F
F234XXXXXXXXXXXXXXXXXXXXXXXXXXXXXXXXXXX234F
FFCCCFFCCCFFCCCFFCCCFFCCCFFCCCFFCCCFFCCCFFF
FFFFFFFFFFFFFFFFFFFFFFFFFFFFFFFFFFFFFFFFFFF
XXXXXXXXXXXXXXXXXXXXXXXXXXXXXXXXXXXXXXXXXXX
XXXXXXXXXXXXXXXXXXXXXXXXXXXXXXXXXXXXXXXXXXX
XXXXXXXXXXXXXXXXXXXXXXXXXXXXXXXXXXXXXXXXXXX
XXXXXXXXXXXXXXXXXXXXXXXXXXXXXXXXXXXXXXXXXXX
