XXXXXXXXXXXXXXXXXXXXXXXXXXXXXXXXXXXXXXXXXXX
XXXXXXXXXXXXXXXXXXXXXXXXXXXXXXXXXXXXXXXXXXX
XXXXXXXXXXXXXXXXXXXXXXXXXXXXXXXXXXXXXXXXXXX
XXXXXXXXXXXXXXXXXXXBXXXXXXXXXXXXXXXXXXXXXXX
XXXXXXXXXXSL1XXXXXCCCCCCCCXXXXXXXXXXXXXXXXX
XXXXXXXXXX234CCCCCXXXXXXXCCCXXXXXXXXXXXXXXX
XXXXXXXXXXCCCCXXXXXXXXXXXXXCCCBXXSR1XXXXXXX
XXXXXXXXXXCXXXXXXXXXXXXXXXXXXCCCX234XXXXXXX
XXXXXXXXCCXXXXXXXXXXXXXXXXXXXXXCCCCCCXXXXXX
XXXXXXXCCXXXXXXXXXXXXXXXXXXXXXXXXXXXCCXXXXX
XXXXXCCCXSL1XXXXXXXXXXXXXXXXXXXXXSR1XCCXXXX
XXXXCCXXX234XXXXXXXXXXBXXXXXXXXXX234XXCCXXX
XXXXFFFFFFFFFCCCFFFFFFFFFFFCCCFFFFFFFXFXXXX
XXXXFXXXXXXXXXXXXXXXXXXXXXXXXXXXXXXXXFFXXXX
XXXXFFFFXXXXXXXXXXXXXXXXXXXXXXXXXXXXXFXXXXX
XXXXXXXFFFXXXXXXXXXXXXXXXXXXXXXXXXXFFFXXXXX
XXXXXXXXXFFFXXXXXXXXXXXXXXXXXXXXXFFFXXXXXXX
XXXXXXXXXXXFXXXXXXXXXXXXXXXXXXCCCFXXXXXXXXX
XXXXXXXXXXXXCCCCCXXXXXXXXXXXXCXXXXXXXXXXXXX
XXXXXXXXXXXXXXXXXCCCCXBXXXCCCXXXXXXXXXXXXXX
XXXXXXXXXXXXXXXXXXXXXCCCCCXXXXXXXXXXXXXXXXX
XXXXXXXXXXXXXXXXXXXXXXXXXXXXXXXXXXXXXXXXXXX
XXXXXXXXXXXXXXXXXXXXXXXXXXXXXXXXXXXXXXXXXXX
FFFFFFFFFFFFFFFFFFFFFFFFFFFFFFFFFFFFFFFFFFF
XXXXXXXXXXXXXXXXXXXXXXXXXXXXXXXXXXXXXXXXXXX
XXXXXXXXXXXXXXXXXXXXXXXXXXXXXXXXXXXXXXXXXXX
XXXXXXXXXXXXXXXXXXXXXXXXXXXXXXXXXXXXXXXXXXX
XXXXXXXXXXXXXXXXXXXXXXXXXXXXXXXXXXXXXXXXXXX
