XXXXXXXXXXXXXXXXXXXXXXXXXXXXXXXXXXXXXXXXXXX
XXXXXXXXXXXXXXXXXXXXXXXXXXXXXXXXXXXXXXXXXXX
XXXXXXXXXXXXXXXXXXXXXXXXXXXXXXXXXXXXXXXXXXX
XXXXXXXXFSL1XXXXXXXXXXXXXXXXXXXXXXXXXXXXXXX
XXXXXXXXF234XXXXXXXXXXXXBXXXXXXXXXXXXXXXXXX
XXXXXXXXFFFFFFCCCCCCCFFFFFFCCCCCCFFFFFXXXXX
XXXXXXXXFFFFFFXXXXXXXFFFFFFXXXXXXFFFFFXXXXX
XXXXXXXXXXXXXXXXXXXXXXXXXXXXXXXXXXXXXXXXXXX
XXXXXXXXXXXXXXXXXXXXXXXXXXXXXXXXXXXXXXXXXXX
XXXXXXXXXXXXXXXXXXXXXXXXXXXXXXXXXXXXXXXXSR1
XXXXXXXXXXXXXXXXXXXXBXXXXXXXXXXXXXXXXXXX234
XXXXXXFFFFFFCCCCCFFFFFFCCCCCFFFFFFCCCCFFFFF
XXXXXXFFFFFFXXXXXFFFFFFXXXXXFFFFFFXXXXFFFFF
XXXXXXXXXXXXXXXXXXXXXXXXXXXXXXXXXXXXXXXXXXX
XXXXXXXXXXXXXXXXXXXXXXXXXXXXXXXXXXXXXXXXXXX
SL1XXXXXXXXXXXXXXXXXXXXXXXXXXXXXXXXXXXXXSR1
234XXXXXXXXXXXXBXXXXXXXXXBXXXXXXXXXXXXXX234
FFFFFFXXXXXXFFFFFXXXXXXFFFFFCCCCCCFFFFFFFFF
FFFFFFXXXXXXFFFFFXXXXXXFFFFFXXXXXXFFFFFFFFF
FXXXXXXXXXXXXXXXXXXXXXXXXXXXXXXXXXXXXXXXXXX
FXXXXXXXXXXXXXXXXXXXXXXXXXXXXXXXXXXXXXXXXXX
FXXXXXXXXXXXXXXXXXXXXXXXXXXXXXXXXXXXXXXXSR1
FXXXXXXXXXXXXXXXXXXXXXXXXXXXXXXXXXXXXXXX234
FFFFFFFFFFFFFFFFFFFFFFFFFFFFFFFFFFFFFFFFFFF
XXXXXXXXXXXXXXXXXXXXXXXXXXXXXXXXXXXXXXXXXXX
XXXXXXXXXXXXXXXXXXXXXXXXXXXXXXXXXXXXXXXXXXX
