XXXXXXXXXXXXXXXXXXXXXXXXXXXXXXXXXXXXXXXXXXX
XXXXXXXXXXXXXXXXXXXXXXXXXXXXXXXXXXXXXXXXXXX
XXXXXXXXXXXXXXXXXXXXXXXXXXXXXXXXXXXXXXXXXXX
XXXXXXXXXXXXXXXXXXXXXXXXXXXXXXXXXXXXXXXXXXX
XXXXXXXXXXXXXXXXXXXXXXXXXXXXXXXXXXXXXXXXXXX
XXXXXXXXXXXXXXSL1XXXXXXXXXXXXXXXXXXXXXXXXXX
XXXXXXXXXXXXXX234XXXXXXXXXXXXXXXXXXXXXXXXXX
XXXXXXXXXXXXXXFFFFFFFFFFFXXXXXXXXXXXXXXXXXX
XXXXXXXXXXXXXXFXXXXXXXXXFXXXXXXXXXXXXXXXXXX
XXXXXXXXXXXXXXFXXXXXXXXXFXXXXXXXXXXXXXXXXXX
XXXXXXXXXXXXXXFXXXXXXXXXFXXXXXXXXXXXXXXXXXX
XXXXXXXXXXXXXXFXXXBXXBXXXXXXXXXXXXXXXXXXXXX
XXXXXXXXXXXXXXFFFFFFFFFXFXXXXXXXXXXXXXXXXXX
XXXXXXXXXXXXXXFXXXXXXXXXXXXXXXXXXXXXXXXXXXX
XXXXXXXXXXXXXXFXXXXXXXXXXXXXXXXXXXXXXXXXXXX
XXXXXXXXXXXXXXFXXXXXXXXXXSR1XXXXXXXXXXXXXXX
XXXXXXXXXXXXXXXXXBXXBXXXX234XXXXXXXXXXXXXXX
XXXXXXXXXXXXXXFXFFFFFFFFFXFFXXXXXXXXXXXXXXX
XXXXXXXXXXXXXXXXXXXXXXXXXXXXXXXXXXXXXXXXXXX
XXXXXXXXXXXXXXXXXXXXXXXXXXXXXXXXXXXXXXXXXXX
XXXXXXXXXXXXXXXXXXXXXXXXXXXXXXXXXXXXXXXXXXX
SL1XXXXXXXXXXXXXXXXXXXXXXXXXXXXXXXXXXXXSR1X
234XXXXXXXXXXXXXXXXXXBXXXXXXXXXXXXXXXXX234X
FFFFFFFFFFFFFFFFFFFFFFFFFFFFFFFFFFFFFFFFFFF
XXXXXXXXXXXXXXXXXFFFFXXXXXXXXXXXXXXXXFFFFXX
XXXXXXXXXXXXXXXXXXXXXXXXXXXXXXXXXXXXXXXXXXX
XXXXXXXXXXXXXXXXXXXXXXXXXXXXXXXXXXXXXXXXXXX
XXXXXXXXXXXXXXXXXXXXXXXXXXXXXXXXXXXXXXXXXXX
