FXXXXXXXXXXXXXXXXXXXXXXXXXXXXXXXXXXXXXXXXXX
FXXXXXXXXXXXXXXXXXXXXXXXXXXXXXXXXXXXXXXXXXX
FXXXXXXXXXXXXXXXXXXXXXXXXXXXXXXXXXXXXXXXXXX
FSL1XXXXXXXXXXXXXXXXXXXXXXXXXXXXXXXXXXXXXXX
F234XXXXXXXXXXXXXXXBXXXXXXXXXXXXXXXXXXXXXXX
FFFFFFFFFFFFCCFFFFFFFFFFFCCFFFFFFFFFFFFFFFF
FXXXXXXXXXXXXXXXXXXXXXXXXXXXXXXXXXXXXXXXXXF
FXXXXXXXXXXXXXXXXXXXXXXXXXXXXXXXXXXXXXXXXXF
FSL1XXXXXXXXXXXXXXXXXXXXXXXXXXXXXXXXXXXSR1F
F234XXXXXXXXXXXXXXXBXXXXXXXXXXXXXXXXXXX234F
FFFFFFFFFFFFCCFFFFFFFFFFFCCFFFFFFFFFFFFFFFF
FXXXXXXXXXXXXXXXXXXXXXXXXXXXXXXXXXXXXXXXXXF
FXXXXXXXXXXXXXXXXXXXXXXXXXXXXXXXXXXXXXXXXXF
FSL1XXXXXXXXXXXXXXXXXXXXXXXXXXXXXXXXXXXXXXF
F234XXXXXXXXXXXXXXXBXXXXXXXXXXXXXXXXXXXXXXF
FFFFFFFFFFFFCCFFFFFFFFFFFCCFFFFFFFFFFFFFFFF
FXXXXXXXXXXXXXXXXXXXXXXXXXXXXXXXXXXXXXXXXXF
FXXXXXXXXXXXXXXXXXXXXXXXXXXXXXXXXXXXXXXXXXF
FXXXXXXXXXXXXXXXXXXXXXXXXXXXXXXXXXXXXXXXXXF
FSL1XXXXXXXXXXXXXXXXXXXXXXXXXXXXXXXXXXXXXXF
F234XXXXXXXXXXXXXXXXXXXXXXXXXXXXXXXXXXXXXXF
FXXXXXXXXXXXXXXXXXXBXXXXXXXXXXXXXXXXXXXXXXF
FFFFFFFFFFFFFFFFFFFFFFFFFFFFFFFFFFFFFFFFFFF
XXXXXXXXXXXXXXXXXXXXXXXXXXXXXXXXXXXXXXXXXXX
XXXXXXXXXXXXXXXXXXXXXXXXXXXXXXXXXXXXXXXXXXX
XXXXXXXXXXXXXXXXXXXXXXXXXXXXXXXXXXXXXXXXXXX
XXXXXXXXXXXXXXXXXXXXXXXXXXXXXXXXXXXXXXXXXXX
XXXXXXXXXXXXXXXXXXXXXXXXXXXXXXXXXXXXXXXXXXX
