XXXXXXXXXXXXXXXXXXXXXXXXXXXXXXXXXXXXXXXXXXX
XXXXXXXXXXXXXXXXXXXXXXXXXXXXXXXXXXXXXXXXXXX
FXXXXXXXXXXXXXXXXXXXXXXXXXXXXXXXXXXXXXXXXFF
FFXXXXXXXXXXXXXXBXXXXXXXXBXXXXXXXXXXXXXXXFX
XFFFFFFFFFFFFFFFFFFFFFFFFFFFFFXXXXXXXXXXFXX
XXFFXXXXXXXXXXXXXXXXXXXXXXXXXXXXXXXXXXXFXXX
XXXFFXXXXXXXXXXXXXXXXXXXXXXXXXXXXXXXXXFFXXX
XXXXXXXXXXXXXXXXXXXXXXXXXXXXXXXXXXXXFFXXXXX
XXXXXXXXBXXXXXXXXXXXXXXXXXXXXXXXXXXXFXXXXXX
XXXSL1XXXXXXXXXXXXXXXXXXXXXXXXXXXSR1FXXXXXX
XXX234XXXXXXXXXXXXXXXXXXXXXXXXXXX234FXXXXXX
XXXFFFFFFFFXXXXXXXXXXXXXXXXXXXFFFFFFFXXXXXX
XXXXXXXXXXFFXXXXXXXXXXXXXXXXXXFFXXXXXXXXXXX
XXXXXXXXXXXFFXXXXXXXXXXXXXXXXFFXXXXXXXXXXXX
XXXXXXXXXXXXFFXXXXXXXXXXXXXXFFXXXXXXXXXXXXX
XXXXXXXXXXXXXFFFXXXXXXXXXBFFFXXXXXXXXXXXXXX
XXXXXXXXXXXXXXXFFXXXXXXXXFFXXXXXXXXXXXXXXXX
XXXXXXXXXXXXXXXXFXXXXXXXXFXXXXXXXXXXXXXXXXX
XXXXXXXXXXXXXXXXXXXXXXXXXXXXXXXXXXXXXXXXXXX
XXXXXXXXXXXXXXXXXXXXXXXXXXXXXXXXXXXXXXXXXXX
XXXXXXXXXXXXXXXXXXXXXXXXXXXXXXXXXXXXXXXXXXX
SL1XXXXXXXXXXXXXXXXXXXXXXXXXXXXXXXXXXXXXSR1
234XXXBXXXXXXXXXXXXXXXXXXXXXXXXXXXBXXXXX234
FFFFFFFFFFFFFFFFFFFFFFFFFFFFFFFFFFFFFFFFFFF
XXXXXXXXXXXXXXXXXXXXXXXXXXFFXXXXXXXXFXXXXXX
XXXXXXXXXXXXXXXXXXXXXXXXXXXXXXXXXXXXXXXXXXX
XXXXXXXXXXXXXXXXXXXXXXXXXXXXXXXXXXXXXXXXXXX
XXXXXXXXXXXXXXXXXXXXXXXXXXXXXXXXXXXXXXXXXXX
