XXXXXXXXXXXXXXXXXXXXXXXXXXXXXXXXXXXXXXXXXXX
XXXXXXXXXXXXXXXXXXXXXXXXXXXXXXXXXXXXXXXXXXX
FXXXXXXXXXXXXXXXXXXXXXXXXXXXXXXXXXXXXXXXXXF
FXXXXXXXXXXXXXXXXXXXXXXXXXXXXXXXXXXXXXXXXXF
FXXXXXXXXXXXXXXXXXXXXXXXXXXXXXXXXXXXXXXXXXF
FXXXXXXXXXXXXXXXXXXXXXXXXXXXXXXXXXXXXXXXXXF
FCCXXXXXXXXXXXXFFFFFFFFFFFFFXXXXXXXXXXXXXXF
FXXCCXXXXXXXXXXXXXXXXXXXXXXXXXXXXXXXXXXXXXF
FXXXXCXXXXXXXXXXXXXXXXXXXXXXXXXXXXXXXXXXXXF
FXXXXXCCXXXXXXXXXXXXXXXXXXXXXXXXXXXXXXXXXXF
FXXXXXXXCCXXXXXXXXXXXXXXXXXXXXXXXCCXXXXXXXF
FXXXXXXXXXCXXXXXXXXXXXXXXXXXXXXXCXXXXXXXXXF
FXXXXXXXXXXXXXXXXXXXXXXXXXXXXXCCXXXXXXXXXXF
FXXXXXXXXXXXXXXXXXXXXXXXXXXXXCXXXXXXXXXXXXF
FXXXXXXXXXXXXXXXXXXXXBXXXXXXCXXXXXXXXXXXXXF
FXXXXXXXXXXXXXXFFFFFFFFFFFFFXXXXXXXXXXXXXXF
FXXXXXXXXXXXXXCXXXXXXXXXXXXXCXXXXXXXXXXXXXF
FXXXXXXXXXXXXCXXXXXXXXXXXXXXXCXXXXXXXXXXXXF
FXXXXXXXXXXXCXXXXXXXXXXXXXXXXXCXXXXXXXXXXXF
FXXXXXXXXXXCXXXXXXXXXXXXXXXXXXXCXXXXXXXXXXF
FXXXXXXXXXCXXXXXXXXXXXXXXXXXXXXXCXXXXXXXXXF
FSL1XXXXXXXXXXXXXXXXXXXXXXXXXXXXXXXXXXXSR1F
F234XXXXXXXXXXXXXXBXXXBXXXXXXXXXXXXXBXX234F
FFFFFFFFFFFFFFFFFFFFFFFFFFFFFFFFFFFFFFFFFFX
XXXXXXXXXXXXXXXXXXXXXXXXXXXXXXXXXXXXXXXXXXX
XXXXXXXXXXXXXXXXXXXXXXXXXXXXXXXXXXXXXXXXXXX
XXXXXXXXXXXXXXXXXXXXXXXXXXXXXXXXXXXXXXXXXXX
XXXXXXXXXXXXXXXXXXXXXXXXXXXXXXXXXXXXXXXXXXX
