XXXXXXXXXXXXXXXXXXXXXXXXFXXXXXXXXXXXXXXXXXX
XXXXXXXXXXXXXXXXXXXXXXXXFXXXXXXXXXXXXXXXXXX
XXXXXXXXXXXXSL1XXXXXXXXXFXXXXXXXXXXXXXXXXXX
XXXXXXXXXXXX234XXXXBXXXXFXXXXXXXXXXXXXXXXXX
XXXXXXXXXXXFFFFFFFFFFFFXFXXXXXXXXXXXXXXXXXX
XXXXXXXXXXXXXXXFXXXXXXXXXXXXXXXXXXXXXXXXXXX
XXXXXXXXXXXXXXXFXXXXXXXXXXXXXXXXXXXXXXXXXXX
XXXXXXXXXXXXXXXFXXXXXXXXXSR1XXXXXXXXXXXXXXX
XXXXXXXXXXXXXXXFXXXBXXXXX234XXXXXXXXXXXXXXX
XXXXXXXXXXXXXXXFXFFFFFFFFFFFXXXXXXXXXXXXXXX
XXXXXXXXXXXXXXXXXXXXXXXXFXXXXXXXXXXXXXXXXXX
XXXXXXXXXXXXXXXXXXXXXXXXFXXXXXXXXXXXXXXXXXX
XXXXXXXXXXXXSL1XXXXXXXXXFXXXXXXXXXXXXXXXXXX
XXXXXXXXXXXX234XXXXBXXXXFXXXXXXXXXXXXXXXXXX
XXXXXXXXXXFFFFFFFFFFFFFXFXXXXXXXXXXXXXXXXXX
XXXXXXXXXXXXXXXFXXXXXXXXFXXXXXXXXXXXXXXXXXX
XXXXXXXXXXXXXXXFXXXXXXXXFXXXXXXXXXXXXXXXXXX
XXXXXXXXXXXXXXXFXXXXXXXXFXXXXXXXXXXXXXXXXXX
XXXXXXXXXXXXXXXXXXXXXXXXXXXXXXXXXXXXXXXXXXX
XXXXXXXXXXXXXXXXXXXXXXXXXXXXXXXXXXXXXXXXXXX
XXXXXXXXXXXXXXXXXXXXXXXXXXXXXXXXXXXXXXXXXXX
XXXXXXXXXXXXXXXXXXXXXXXXXXXXXXXXXXXXXXXXSR1
XXXXXXXXXXXXXXXXXXXXXXXXXXXXXXXXXXXXXXXX234
FFFFFFFFFFFFFFFFFFFFFFFFFFFFFFFFFFFFFFFFFFF
XXXXFFFXXXXFFXXXXXXXXXXXFXXXXXXXXXXXXXXXXXX
XXXXXXXXXXXXXXXXXXXXXXXXXXXXXXXXXXXXXXXXXXX
XXXXXXXXXXXXXXXXXXXXXXXXXXXXXXXXXXXXXXXXXXX
XXXXXXXXXXXXXXXXXXXXXXXXXXXXXXXXXXXXXXXXXXX
