XXXXXXXXXXXXXXXXXXXXXXXXXXXXXXXXXXXXXXXXXXX
XXXXXXXXXXXXXXXXXXXXXXXXXXXXXXXXXXXXXXXXXXX
XXXXXXXXXXXXXXXXXXSL1XXXXXXXXXXXXXXXSR1XXXX
XXXXXXXXXXXXXXXXXX234XXBXXXXXXXXXXXX234XXXX
XXXXSL1XXXXXSR1XXXFFFFFCCCFFFFFFFFFFXXXXXXX
XXXF234XXXXB234FXXXXXFXXXXXXXXXXXXXXXXXXXXX
XXXXFFFFCCCFFFFXXXXXXFFXXXXXXXXXXXXXXXXXXXX
XXXXXXXXXXXXXXXXXXXXXXXFXXXXXXXXXXXXXXXXXXX
XXXXXXXXXXXXXXXXXXXXXXXXCXXXXXXXXXXXXXXXXXX
XXXXXXXFSL1XXXXXXXXXXXXXXCXXXXXXXXXXXXXXXXX
XXXXXXXF234XXXXXXXXXXBXXXXCXSR1XXXXXXXXXXXX
XXXXXXXFFFFFFFFXXXXXXXXXXXXX234XXXXXXXXXXXX
XXXXXXXXXXXXXXSL1XXXXXXXXXFFFFFXXXXXSR1FXXX
XXXXXXXXXXXXXX234XXXXXXXXFXXXXXXXXXX234FXXX
XXXXXXXXXXXXXXXFFFFFXXXXFXXXXXXXXXFFFFFFXXX
XXXXXXXXXXXXXXXXXFFFFXXFXXXXXXXXXSR1FXXXXXX
XXXXXXXXXXXXXXXXXXFFFFXXXXXXXXXBX234FXXXXXX
XXXXXXXXXXXXXXXXXXXXXXXXXXXXXXXXXFFFFXXXXXX
XXXXXXXXXXXXXXXXXXXXXXXXXXXXXXXXFXXXXXXXXXX
XXXXXXXXXXXXFSL1XXXXXXXXXXXXXXXFXXXXXXXXXXX
XXXXXXXXXXXXF234XXXXXXBXXXXXXXFXXXXXXXXXXXX
XXXXXXXXXXXXFFFFFFFFFFCCCCFFFFXXXXXXXXXXXXX
XXXXXXXXXXXXXXXXXXXXXFXXXXFXXXXXXXXXXXXXXXX
XXXXXXXXXXXXXXXXXXXXXFFFFFFXXXXXXXXXXXXXXXX
XXXXXXXXXXXXXXXXXXXXXXXXXXXXXXXXXXXXXXXXXXX
XXXXXXXXXXXXXXXXXXXXXXXXXXXXXXXXXXXXXXXXXXX
XXXXXXXXXXXXXXXXXXXXXXXXXXXXXXXXXXXXXXXXXXX
XXXXXXXXXXXXXXXXXXXXXXXXXXXXXXXXXXXXXXXXXXX
