XXXXXXXXXXXXXXXXXXXXXXXXXXXXXXXXXXXXXXXXXXX
XXXXXXXXXXXXXXXXXXXXXXXXXXXXXXXXXXXXXXXXXXX
XXXXXXXXXXXXXXXXXXXXXXXXXXXXXXXXXXXXXXXXXXX
XXXXXFSL1XXXXXXXXXXXXXXXXXXXXXXXXXXXXXXXXXX
XXXXXF234XXXXXXXXXXXXXXXXXXXXXXXXXXXXXXXXXX
XXXXXFFFFFFFFFFFFFFFFFFCCXXXXXXXXXXXXXXXXXX
XXXXXXXXXXXXXXXXXXXXXXXXXXXXXXXXXXXXXXXXXXX
XXXXXXXXXXXXXXXXXXXXXXXXXXXXXXXXXXXXXXXXXXX
XXXXXXXXXXXXXXXXXXXXXXXXXXXXXXXXXXXXXXXXXXX
XXXXXXXXXXXXFSL1XXXXXXXXXSR1FXXXXXXXXXXXXXX
XXXXXXXXXXXXF234XXXXXXXXX234FXXXXXXXXXXXXXX
XXXXXXXXXXXXFFFFFFCCCCCFFFFFFXXXXXXXXXXXXXX
XXXXXXXXXXXXXXXXXXCCCCCXXXXXXXXXXXXXXXXXXXX
XXXXXXXXXXXXXXXXXXXXXXXXXXXXXXXXXXXXXXXXXXX
XXXXXXXXXXXXXXXFSL1XXXSR1FXXXXXXXXXXXXXXXXX
XXXXXXXXXXXXXXXF234XBX234FXXXXXXXXXXXXXXXXX
XXXXXXXXXXXXXFFFFFCCCCCFFFFFXXXXXXXXXXXXXXX
XXXXXXXXXXXXXFFFSL1XXXSR1FFFXXXXXXXXXXXXXXX
XXXXXXXXXXXXXXFF234XBX234FFXXXXXXXXXXXXXXXX
XXXXXXXXXXXXXXXXXXCCCCCXXXXXXXXXXXXXXXXXXXX
SL1XXXXXXXXXXXXXXXXXXXXXXXXXXXXXXXXXXXXXSR1
234XXXXXXXXXXXXXXXXBBBXXXXXXXXXXXXXXXXXX234
FFFFFFFFFFFFFFFFFFFFFFFFFFFFFFFFFFFFFFFFFFF
XXXXXXXXXXXXXXXXXXXXXXXXXXXXXXXXXXXXXXXXXXX
XXXXXXXXXXXXXXXXXXXXXXXXXXXXXXXXXXXXXXXXXXX
XXXXXXXXXXXXXXXXXXXXXXXXXXXXXXXXXXXXXXXXXXX
XXXXXXXXXXXXXXXXXXXXXXXXXXXXXXXXXXXXXXXXXXX
XXXXXXXXXXXXXXXXXXXXXXXXXXXXXXXXXXXXXXXXXXX
